L Barrault	/citations?user=S6Xj1BYAAAAJ&hl=en&oi=sra
O Bojar	/citations?user=G_65vFsAAAAJ&hl=en&oi=sra
MR Costa-Jussa	/citations?user=ESqQ7FoAAAAJ&hl=en&oi=sra
C Federmann	/citations?user=FIkUVv4AAAAJ&hl=en&oi=sra
P Koehn	/citations?user=OsIZgIYAAAAJ&hl=en&oi=sra
H Khayrallah	/citations?user=muJh2XQAAAAJ&hl=en&oi=sra
K Heafield	/citations?user=VEJE37AAAAAJ&hl=en&oi=sra
R Aharoni	/citations?user=wV0mHWgAAAAJ&hl=en&oi=sra
Y Goldberg	/citations?user=0rskDKgAAAAJ&hl=en&oi=sra
M Bañón	/citations?user=Ribl9ZQAAAAJ&hl=en&oi=sra
P Chen	/citations?user=m_HgJe0AAAAJ&hl=en&oi=sra
B Haddow	/citations?user=6NqRjRYAAAAJ&hl=en&oi=sra
K Heafield	/citations?user=VEJE37AAAAAJ&hl=en&oi=sra
F Stahlberg	/citations?user=NA8fvj8AAAAJ&hl=en&oi=sra
B Thompson	/citations?user=6IGa-LoAAAAJ&hl=en&oi=sra
M Post	/citations?user=4w7LhxsAAAAJ&hl=en&oi=sra
M Junczys-Dowmunt	/citations?user=Uh_GH14AAAAJ&hl=en&oi=sra
I Caswell	/citations?user=myh9l2AAAAAJ&hl=en&oi=sra
C Chelba	/citations?user=Rtg5ZY8AAAAJ&hl=en&oi=sra
M Pinnis	/citations?user=KGgdwWwAAAAJ&hl=en&oi=sra
M Rikters	/citations?user=ocUBoAUAAAAJ&hl=en&oi=sra
R Krišlauks	/citations?user=tOaTdTQAAAAJ&hl=en&oi=sra
S Hisamoto	/citations?user=7DTtrgIAAAAJ&hl=en&oi=sra
M Post	/citations?user=4w7LhxsAAAAJ&hl=en&oi=sra
K Duh	/citations?user=M3BSiiQAAAAJ&hl=en&oi=sra
J Kreutzer	/citations?user=j4cOSzAAAAAJ&hl=en&oi=sra
I Caswell	/citations?user=myh9l2AAAAAJ&hl=en&oi=sra
L Wang	/citations?user=5KmYPkIAAAAJ&hl=en&oi=sra
C Zhou	/citations?user=mR5W7EgAAAAJ&hl=en&oi=sra
G Neubig	/citations?user=wlosgkoAAAAJ&hl=en&oi=sra
J Gu	/citations?user=cB1mFBsAAAAJ&hl=en&oi=sra
M Diab	/citations?user=-y6SIhQAAAAJ&hl=en&oi=sra
ZY Dou	/citations?user=RWogNsEAAAAJ&hl=en&oi=sra
A Anastasopoulos	/citations?user=g_G_SNAAAAAJ&hl=en&oi=sra
G Neubig	/citations?user=wlosgkoAAAAJ&hl=en&oi=sra
S Xu	/citations?user=jO8qUfcAAAAJ&hl=en&oi=sra
SJ Semnani	/citations?user=ECn_7SYAAAAJ&hl=en&oi=sra
G Campagna	/citations?user=fOioY3wAAAAJ&hl=en&oi=sra
MS Lam	/citations?user=4hS0jZ8AAAAJ&hl=en&oi=sra
Y Tian	/citations?user=A0XKdHAAAAAJ&hl=en&oi=sra
J Ngiam	/citations?user=n0pk_jEAAAAJ&hl=en&oi=sra
Y Yang	/citations?user=kvDbu90AAAAJ&hl=en&oi=sra
I Caswell	/citations?user=myh9l2AAAAAJ&hl=en&oi=sra
G Ramesh	/citations?user=VDb6XokAAAAJ&hl=en&oi=sra
S Doddapaneni	/citations?user=_kR4rGAAAAAJ&hl=en&oi=sra
V Raunak	/citations?user=25Tjnq4AAAAJ&hl=en&oi=sra
A Menezes	/citations?user=DnhOg3YAAAAJ&hl=en&oi=sra
M Junczys-Dowmunt	/citations?user=Uh_GH14AAAAJ&hl=en&oi=sra
J Lichtarge	/citations?user=Rg0d8sMAAAAJ&hl=en&oi=sra
C Alberti	/citations?user=SA1BuxoAAAAJ&hl=en&oi=sra
B Zhang	/citations?user=5_24s8QAAAAJ&hl=en&oi=sra
A Nagesh	/citations?user=lR38gZkAAAAJ&hl=en&oi=sra
K Knight	/citations?user=oQnyyGkAAAAJ&hl=en&oi=sra
D Saunders	/citations?user=mBl92d8AAAAJ&hl=en&oi=sra
